Pick up the lucky block, surprise! Jump on the rocket!
21
.......................
.................X.....
..........##########---
.......................
WWW....WWWW.........---
---....####............
....................---
WWW....................
###.........WWWWW...---
............#####......
....WWW.............---
....###................
...................R---
.1...?....W.W.W.W.W....s
########################